WWWWWWWWWW
W        W
W  VHH   W
W  V  F  W
W  V WXWWW
W    T   
W    WR  W
W T      W
W W RSB YW
WWWWWWWWWW