WWWWWWWWWW
W  CCC   W
W CHHH   W
W C  C   W
W R  WXWWW
W B  T
W    W   W
W   A    W
W   S    W
WWWWWWWWWW