WWWWWWWWWW
 F   b   W
W    W   W
W        W
W        W
W     C  W   
WWWWWWW  W
W  A  X  W
WS WB W  W
WWWWWWWWWW