WWWWWWWWWW
W S C    W
W  HHHH  W
W        W
W    WXWWW
W B  W
W    W   W
W    W   W
W        W
WWWWWWWWWW