WWWWWWWWWW
W        W
W  VHH   W
W  V  F  W
W  V WXWWW
W    T  R
W    W   W
W        W
W R S B YW
WWWWWWWWWW