WWWWWWWWWW
W  B     W
W  HHHH  W
W        W
W  C WXWWW
W  C W
W  S W   W
W    W   W
W        W
WWWWWWWWWW