WWWWWWWWWW
W   S A  W
W  HHHH  W
W AC     W
W C  WXWWW
W B  W
W    W   W
W    W   W
W    T   W
WWWWWWWWWW