WWWWWWWWWW
W        W
W  HHH   W
W        W
W    WXWWW
W    T
W    W   W
W        W
W B S    W
WWWWWWWWWW