WWWWWWWWWW
W   b   SW
W   HHH  W
W    B A W
W    WXWWW
W    T R 
W    W   W
W        W
W F    Y W
WWWWWWWWWW