WWWWWWWWWW
W    S   W
W   HHH   W
W     B  W
W    WXWWW
W    T   
W    W   W
W        W
W        W
WWWWWWWWWW