WWWWWWWWWW
W        W
W  HHH   W
W   C    W
W   CWXWWW
W    T 
W R  W   W
W        W
W B S    W
WWWWWWWWWW