WWWWWWWWWW
W   B    W
W  HHHH  W
W        W
W    WXWWW
W  A W
W  S W   W
W    W   W
W        W
WWWWWWWWWW