WWWWWWWWWWW
W  Rb  B W
W  HHHHHHW
 V  W    W
W   T    W
W R W    W
W H W    W
W   W    W
W   W S  W
WWWWWWWWWW