WWWWWWWWWW
W  Rb  B W
W  HHHHHHW
 V  W    W
W   T C  W
W R W X  W
W H W    W
W   W    W
W   W S  W
WWWWWWWWWW