WWWWWWWWWW
W        W
W RHH    W
W R      W
W    WXWWW
W B  T
W    WS  W
W   R    W
W   RR   W
WWWWWWWWWW