WWWWWWWWWW
W A S    W
W CHHHH  W
W CC     W
W CA WXWWW
W B  W
W    W A W
W    W A W
W        W
WWWWWWWWWW