WWWWWWWWWW
W        W
W  VHH   W
W  V     W
W  V WXWWW
W    T  R
W R  W   W
W        W
W b S B YW
WWWWWWWWWW