WWWWWWWWWW
W  CCC   W
W  HHH   W
W    C   W
W    WXWWW
W B  T
W   RW   W
W        W
W   S    W
WWWWWWWWWW