WWWWWWWWWW
W S CC   W
W  HHHH  W
W        W
W    WXWWW
W B  W
W    W   W
W    W   W
W    X   W
WWWWWWWWWW