WWWWWWWWWW
W C S    W
W CHHHH  W
W CC     W
W CA WXWWW
W    W
W  B W A W
W    W A W
W        W
WWWWWWWWWW