WWWWWWWWWW
W        W
W RHH    W
W     C  W
W    WXWWW
W B  T
W    WS  W
W        W
W    A   W
WWWWWWWWWW