WWWWWWWWWW
W   b  B W
W   R    W
W   W    W
W        W
W H      W
W        W
W    WWWWW
W   Y S  W 
WWWW WWWWW