WWWWWWWWWW
W   S A  W
W  HHHH  W
W  C     W
W CA WXWWW
W B  W
W    W   W
W    W   W
W        W
WWWWWWWWWW