WWWWWWWWWW
W     CCW
W  B   HH W
W  F     W
W     CC W
W     HH W
W C     BW
W W     SW
W        W
WWWWWWWWWW