WWWWWWWWWW
W  B     W
W  HHHH  W
W        W
W    WXWWW
W    W
W  S W   W
W    W   W
W    T   W
WWWWWWWWWW