WWWWWWWWWW
W S      W
W AHHHH  W
W     C  W
W    WXWWW
W B  T
W    W   W
W        W
W    A   W
WWWWWWWWWW