WWWWWWWWWW
W   b   SW
W   HHH  W
W   T  A W
W    WXWWW
W    T R 
W    W   W
W        W
W F B  Y W
WWWWWWWWWW