WWWWWWWWWW
W  Rb CB W
W  HHHTHHW
 V  W    W
W   T C  W
W R W XC W
W H W  F W
W   W    W
W   W S  W
WWWWWWWWWW